R 800 600
NO ./textures/colorstone.xpm
SO ./textures/greystone.xpm
WE ./textures/mossy.xpm
EA ./textures/wood.xpm
S ./textures/chest.xpm
F 220,100,0
C 225,30,0

        1111111111111111111111111
        1000000000110000000000001
        1000000001110000002000001
        1000000000000000000000001
111111111000000001110000000000001
100000000000000001110000000011111
11110000011111011100000000001
11110000011111011101011100001
1100000000000000000001 100N01
10002000000000000000011100001
10000000000000000000000000001
1100000111010101110000000000111
11110111 1110101 101111010201
11111111 1111111 111111111111
