R 640 480
NO ./textures/colorstone.xpm
SO ./textures/greystone.xpm
WE ./textures/mossy.xpm
EA ./textures/wood.xpm
S ./textures/chest.xpm
F 220,100,0
C 225,30,0


1111111111
1000002001
1000W00001
1111111111
