R 1080 720
NO ./textures/greystone.xpm
SO ./textures/colorstone.xpm
WE ./textures/wood.xpm
EA ./textures/mossy.xpm
S ./textures/barrel.xpm
F 220,100,0
C 225,30,0

        1111111111111111111111111
        1000000000110000000000001
        1011000001110000002000001
        1001000000000000000000001
111111111011000001110000000000001
100000000011000001110111110111111
11110111111111011100000010001
11110111111111011101011111201
1100000011010101110001 100N01
10002000000000000000011111001
10000000000000001101010000001
1100000111010101111101111000111
11110111 1110101 101111010201
11111111 1111111 111111111111
